a        - ah, ha, uh, oh, ooh, aw, well (emotion word)
akesi    - non-cute animal, reptile, amphibian
ala      -  no, not, none, un-, nothing, negation, zero
ale, ali - everything, anything, life, the universe, all, every, complete, whole
anpa     - bottom, lower part, under, below, floor, beneath
ante     - difference, different, otherwise, or else, to change, alter, modify
anu      - or
awen     - stay, wait, remain, keep, remaining, stationary, permanent, sedentary
e (separator, introduces a direct object)
en       - and
esun     - market, shop
ijo      - thing, something, stuff, anything, object, of something, to objectify
ike      - bad, negative, wrong, evil, overly complex, alas! to make bad, to worsen, to have a negative effect upon, to be bad, to suck
ilo      - tool, device, machine, thing used for a specific purpose
insa     - inside, inner world, center, stomach, inner, internal
jaki     - dirty, gross, filthy, dirt, pollution, garbage, filth, to pollute, to make dirty, yuck!
jan      - person, people, human, being, somebody, anybody, human, somebody's, personal, of people, to personify, humanize, personalize
jelo     - yellow, light green
jo       - to have, to contain, having (kama - receive, get, take, obtain)
kala     - fish, sea creature
kalama   - sound, noise, voice, to make noise, to sound, ring, play (an instrument)
kama     - come, become, arrive, happen, pursue actions to arrive to (a certain state), manage to, start to, event, happening, chance, arrival, beginning, coming, future, to bring about, summon
kasi     - plant, leaf, herb, tree, wood
ken      - can, is able to, is allowed to, may, is possible, possibility, ability, power to do things, permission, to make possible, enable, allow, permit (cont - it is possible that)
kepeken  - use, with
kili     - fruit, pulpy vegetable, mushroom
kin      - also, too, even, indeed (emphasizes the word(s) before it)
kipisi   - to cut
kiwen    - hard, solid, stone-like, made of stone or metal, hard thing, rock, stone, metal, mineral, clay
ko       - semi-solid or squishy substance, e.g. paste, powder, gum
kon      - air, wind, smell, soul, air-like, ethereal, gaseous
kule     - color, paint, colorful, to color, paint
kute     - to listen, hear, auditory, hearing
kulupu   - group, community, society, company, people, communal, shared, public, of the society
la (separator between adverb or phrase of context and sentence)
lape     - sleep, rest, sleeping, of sleep
laso     - blue, blue-green
lawa     - head, mind, main, leading, in charge, to lead, control, rule, steer
len      - clothing, cloth, fabric
lete     - cold, uncooked, to cool down, chill
li (seperator between any subject except mi and sina and its verb; also used to introduce a new verb for the same subject)
lili     - small, little, young, a bit, short, few, less, to reduce, shorten, shrink, lessen
linja    - long, very thin, floppy thing, e.g. string, rope, hair, thread, cord, chain
lipu     - flat and bendable thing, e.g. paper, card, ticket
loje     - red
lon      - be (located) in/at/on, to be there, be present, be real/true, exist, be awake
luka     - hand, arm
lukin    - see, look at, watch, read, to look, watch out, pay attention, visual(ly)
lupa     - hole, orifice, window, door
ma       - land, earth, country, (outdoor) area
mama     - parent, mother, father, parental, maternal, fatherly
mani     - money, material wealth, currency, dollar, capital
meli     - woman, female, girl, wife, girlfriend, female, feminine, womanly
mi       - I, we, my, our
mije     - man, male, boy, husband, boyfriend, male, masculine, manly
moku     - food, meal, eat, drink, swallow, ingest, consume
moli     - death, die, be dead, kill, deadly, fatal
monsi    - back, rear end, butt, behind
mun      - moon, lunar
musi     - fun, playing, game, recreation, art, entertainment, artful, fun, recreational, have fun, amuse, entertain
mute     - many, very, much, several, a lot, abundant, numerous, more, amount, quantity, to make many or much
namako   - extra, addtional, spice
nanpa    - number, -th (ordinal numbers)
nasa     - silly, crazy, foolish, drunk, strange, stupid, weird, to drive crazy, make weird
nasin    - way, manner, custom, road, path, doctrine, system, method
nena     - bump, nose, hill, mountain, button
ni       - this, that
nimi     - word, name
noka     - leg, foot
o (sep O vocative or imperative) hey! (calling somebody's attention)
oko      - eye
olin     - love, to love (a person)
ona      - she, he, it, they, her, his, its, their
open     - open, turn on
pakala   - blunder, accident, mistake, destruction, damage, breaking, to screw up, fuck up, botch, ruin, break, hurt, injure, damage, spoil, ruin, to screw up, fall apart, break, damn! fuck!
pali     - activity, work, deed, project, active, work-related, operating, working, to do, make, build, create, to act, work, function
palisa   - long, mostly hard object, e.g. rod, stick, branch
pan      - grain, cereal
pana     - to give, put, send, place, release, emit, cause, giving, transfer, exchange
pi (sep	of, belonging to)
pilin    - feelings, emotion, heart, to feel, think, sense, touch
pimeja   - black, dark, darkness, shadows, darken
pini     - end, tip, completed, finished, past, done, ago, to finish, close, end, turn off
pipi     - bug, insect, spider
poka     - side, hip, next to, in the accompaniment of, with, neighbouring
poki     - container, box, bowl, cup, glass
pona     - good, simplicity, positivity, simple, positive, nice, correct, right, great! good! thanks! OK! cool! yay!, to improve, fix, repair, make good
sama     - same, similar, equal, of equal status or position, like, as, seem
seli     - fire, warmth, heat, hot, warm, cooked, to heat, warm up, cook
selo     - outside, surface, skin, shell, bark, shape, peel
seme     - what, which, wh- (question word)
sewi     - high, up, above, top, over, on, superior, elevated, religious, formal
sijelo   - body, physical state
sike     - circle, wheel, sphere, ball, cycle, round, cyclical
sin      - new, fresh, another, more, to renew, renovate, freshen
sina     - you, your
sinpin   - front, chest, torso, face, wall
sitelen  - picture, image, to draw, write
sona     - knowledge, wisdom, intelligence, understanding, to know, understand, know how to, learn, study
soweli   - animal, especially land mammal, lovable animal
suli     - big, tall, long, adult, important, to enlarge, lengthen, size
suno     - sun, light
supa     - horizontal surface, e.g furniture, table, chair, pillow, floor
suwi     - candy, sweet food, sweet, cute, to sweeten
tan      - from, by, because of, since, origin, cause
taso     - only, sole, but
tawa     - to, in order to, towards, for, until, to go to, walk, travel, move, leave, movement, transportation, moving, mobile, to move, displace
telo     - water, liquid, juice, sauce, to water, wash with water
tenpo    - time, period of time, moment, duration, situation
toki     - language, talking, speech, communication, talking, verbal, to say, talk, chat, communicate, hello! hi!
tomo     - indoor constructed space, e.g. house, home, room, building, urban, domestic, household
tu       - two, duo, pair, to double, separate/cut/divide in two
unpa     - sex, sexuality, erotic, sexual, to have sex with, sleep with, fuck
uta      - mouth, oral
utala    - conflict, disharmony, competition, fight, war, battle, attack, blow, argument, physical or verbal violence, to hit, strike, attack, compete against
walo     - white, light (colour), white thing or part, whiteness, lightness
wan      - one, a, unit, element, particle, part, piece, to unite, make one
waso     - bird, winged animal
wawa     - energy, strength, power, energetic, strong, fierce, intense, sure, confident, to strengthen, energize, empower
weka     - away, absent, missing, absence, to throw away, remove, get rid of
wile     - to want, need, wish, have to, must, will, should, desire, need, will, necessary
